NO ./texture/matrix.xpm
SO  ./texture/matrix.xpm
WE ./texture/matrix.xpm
EA ./texture/matrix.xpm

C 0,0,0
F 0,0,0

111111111111111111111111111111
100000000000000000000000000001
101111111111100111111111111101
101000000000100100000000000101
101011111110100101111111110101
101010000010100100000000010101
101010110010111111111111010101
101010110010000000000001010101
101010110011111111111101010101
101010110000000000000101010101
101010111111111111110101010101
101010000000000000010101010101
101011111111111111110101010101
101000000000000000000101010101
101111111111111111111101010101
100000000000000000000001010101
111111111111111111111111010101
100000000000000000000000010101
101111111111111111111111110101
101000000000000000000000000101
101011111111111111111111111101
101010000000000000000000000001
101010111111111111111111111111
101010000000000000000000000001
101011111111111111111111110101
101000000000000000000000010101
1011111111110011111111111010101
100000000001N10000000000010101
111111111111111111111111111111