SO  ./texture/brick.xpm
WE ./texture/grey_stone.xpm
EA ./texture/purple_stone.xpm
NO ./texture/red_brick.xpm

C 0,0,0
F 128,128,258

1111111111111111111111111
1000000000110000000000001
101100000111000000000001
10010000000000000000000011111111
111111111011000001110000000000001
100000000011000001110111111111111
11110111111111011100000010001
11110111111111011101010000001
11000000110101011100000010001
10000000000000000000000010001
10000000000000001101010010001
11000001110101011111010010N0111
11110111 1110101 101111000001
11111111 1111111 111111111111