NO ./texture/north.xpm
SO  ./texture/south.xpm
WE ./texture/west.xpm
EA ./texture/east.xpm

C 0,0,0
F 0,0,0

11111111111111111111111111111111
10000000000000000000000000000001
10000000000000000000000000000001
10000010000000000000000000001001
10000000000000000000000000000001
10000000000001000000000000000001
10000000000000000000000000000001
10000000000000000000000000000001
1S000000000000000000000000000001
11111111111111111111111111111111